############################
#..........................#
#.########################.#
#..........................#
#############.##############
#..........................#
#.########################.#
#............P.............#
############################